[console_scripts]
EnrichmentAnalysis = RiboAnalyzer.EnrichmentAnalysis:main
EnrichmentAnalysisForSingleTrans = RiboAnalyzer.EnrichmentAnalysisForSingleTrans:main
ExtractSequenceCenteredOnAPosition = RiboAnalyzer.ExtractSequenceCenteredOnAPosition:main
GCContent = RiboAnalyzer.GCContent:main
GetProteinCodingSequence = RiboAnalyzer.GetProteinCodingSequence:main
GetUTRSequences = RiboAnalyzer.GetUTRSequences:main
LengthDistribution = RiboAnalyzer.LengthDistribution:main
MergeSampleDensitys = RiboAnalyzer.MergeSampleDensitys:main
MetageneAnalysis = RiboAnalyzer.MetageneAnalysis:main
MetageneAnalysisForTheWholeRegions = RiboAnalyzer.MetageneAnalysisForTheWholeRegions:main
OutputTranscriptInfo = RiboAnalyzer.OutputTranscriptInfo:main
PausingScore = RiboAnalyzer.PausingScore:main
Periodicity = RiboAnalyzer.Periodicity:main
PlotEnrichmentRatio = RiboAnalyzer.PlotEnrichmentRatio:main
PlotGCContent = RiboAnalyzer.PlotGCContent:main
PlotHydropathyCharge = RiboAnalyzer.PlotHydropathyCharge:main
PlotMetageneAnalysis = RiboAnalyzer.PlotMetageneAnalysis:main
PlotMetageneAnalysisForTheWholeRegions = RiboAnalyzer.PlotMetageneAnalysisForTheWholeRegions:main
PlotPolarity = RiboAnalyzer.PlotPolarity:main
PlotRiboDensityAroundTriAAMotifs = RiboAnalyzer.PlotRiboDensityAroundTriAAMotifs:main
PlotRiboDensityAtEachKindAAOrCodon = RiboAnalyzer.PlotRiboDensityAtEachKindAAOrCodon:main
PolarityCalculation = RiboAnalyzer.PolarityCalculation:main
ProcessPausingScore = RiboAnalyzer.ProcessPausingScore:main
RPFdist = RiboAnalyzer.RPFdist:main
RiboDensityAroundTripleteAAMotifs = RiboAnalyzer.RiboDensityAroundTripleteAAMotifs:main
RiboDensityAtEachKindAAOrCodon = RiboAnalyzer.RiboDensityAtEachKindAAOrCodon:main
RiboDensityAtEachPosition = RiboAnalyzer.RiboDensityAtEachPosition:main
RiboDensityForSpecificRegion = RiboAnalyzer.RiboDensityForSpecificRegion:main
RiboDensityOfDiffFrames = RiboAnalyzer.RiboDensityOfDiffFrames:main
StatisticReadsOnDNAsContam = RiboAnalyzer.StatisticReadsOnDNAsContam:main
cAI = RiboAnalyzer.cAI:main
cAIPlot = RiboAnalyzer.cAIPlot:main
enrichmentMeanDensity = RiboAnalyzer.enrichmentMeanDensity:main
hydropathyCharge = RiboAnalyzer.hydropathyCharge:main
tAI = RiboAnalyzer.tAI:main
tAIPlot = RiboAnalyzer.tAIPlot:main

